
7 1 0 0 0 0 0 0 0 0 0 W W W W W 0 0 0 0 0 0 0 0 0 0 W W 0 0 0 0 W 0 0 0 0 0 0 0 0 0 0 0 1 2 0 0 0 0 0 0 0 0 0 0 0 0 0 0 0 0 0 1 2 0 0 0 0 0 0 W 0 0 0 0 0 0 0 0 1 2 0 0 W 0 0 0 0 0 0 0 W 0 0 0 0 0 0 0 0 0 0 W 0 0 0 0 0 0 0 W 0 0 0 0 9 9 9 9 9 0 0 0 W 0 0 0 0 0 0 0 0 0 0 0 0 0 0 0 0 0 0 0 0 0 0 1 1 0 0 0 0 0 0 0 0 0 0 0 0 0 0 W 0 0 0 0 W W 0 0 0 0 0 0 0 0 0 0 W W W W W 0 0 0 0 0 0 0 0 0 0 0 
8 1 0 0 0 0 0 0 0 0 0 W 0 0 0 0 0 0 0 0 0 0 0 0 0 0 0 0 0 0 0 W W 0 0 0 0 0 0 0 0 0 0 0 0 1 0 0 0 0 0 0 0 0 0 0 0 0 0 0 W W 0 1 0 0 0 0 0 0 0 0 0 0 0 0 0 0 0 0 0 1 0 0 W 0 0 0 0 0 0 0 W 0 0 0 0 0 0 0 0 0 0 W 0 0 0 0 0 0 0 W 0 0 9 9 9 9 9 9 9 9 0 0 0 0 0 0 0 0 0 0 0 0 W W 0 0 0 0 0 0 0 0 0 0 0 0 0 0 0 0 0 0 0 0 0 0 0 0 0 0 0 W W 0 0 0 0 0 0 0 0 0 0 0 0 0 0 0 0 0 0 0 W 0 0 0 0 1 2 2 0 3 3 4 
1 0 0 0 0 0 0 0 0 0 W 0 0 0 0 0 0 0 0 0 0 0 0 0 0 0 0 0 0 0 0 0 W 0 0 0 0 0 0 0 0 0 0 0 0 0 0 0 0 0 0 0 0 0 0 0 0 W W W W 0 0 1 0 0 0 0 0 0 0 0 0 0 0 0 0 0 0 0 0 1 0 0 0 W 0 0 0 0 0 W 0 0 0 0 0 0 0 0 0 0 0 0 W 0 0 0 0 0 W 0 0 1 9 9 9 9 9 9 9 9 0 0 0 0 0 0 0 0 0 0 0 0 0 W W W W 0 0 0 0 0 0 0 0 0 0 0 0 0 0 0 0 0 0 0 0 0 0 0 0 W 0 0 0 0 0 0 0 0 0 0 0 0 0 0 0 0 0 0 0 0 0 W 0 0 0 0 0 0 1 2 2 3 
1 0 0 0 0 0 0 0 0 W 0 0 0 0 0 0 0 0 0 0 0 0 0 0 0 0 0 A 0 0 0 0 W 0 0 0 0 0 0 0 0 0 0 0 0 0 1 0 0 0 0 0 0 0 W W W W 0 0 0 0 1 2 0 0 0 0 0 0 0 0 0 0 0 0 0 0 0 0 0 1 2 0 0 W 0 0 0 0 0 W 0 0 0 0 0 0 0 0 0 0 0 0 W 0 0 0 0 0 W 0 0 0 0 1 9 9 9 9 9 9 9 0 0 0 0 0 0 0 0 0 0 0 0 0 0 0 W W W W 0 0 0 0 0 0 0 0 0 0 0 0 0 0 0 0 0 0 0 0 0 W 0 0 0 0 0 0 0 0 0 0 0 0 0 0 0 0 0 0 0 0 0 0 W 0 0 0 0 0 0 0 1 2 
1 0 0 0 0 0 0 0 0 W 0 0 0 0 0 0 0 0 1 0 0 W 0 0 0 0 0 0 0 0 0 0 0 0 0 0 0 0 0 0 0 0 0 0 0 0 0 0 0 0 0 0 0 W W W 0 0 0 0 0 0 1 0 0 0 0 0 0 0 0 A 0 0 0 0 0 0 0 0 0 0 1 0 0 W W 0 0 0 W W 0 0 0 0 0 0 0 0 0 0 0 0 W W 0 0 0 W W 0 0 0 0 0 1 9 9 9 9 9 9 9 0 0 0 0 0 0 0 0 0 0 0 0 0 0 0 0 W W W 0 0 0 0 0 0 0 0 0 0 0 0 0 0 0 0 0 0 0 0 0 0 0 0 0 0 0 0 0 0 0 W 0 0 0 0 0 0 0 0 0 0 0 W 0 0 0 0 0 0 0 0 1 
0 0 0 0 0 0 0 0 0 0 A 0 0 0 0 0 0 0 0 0 0 W 0 0 0 0 0 0 0 0 0 0 0 0 0 0 0 0 0 0 0 0 0 0 0 0 0 0 0 0 0 0 0 W 0 0 0 0 0 0 0 1 2 3 0 0 W 0 0 0 0 0 0 0 0 0 0 0 0 0 0 1 0 0 0 0 W 0 0 0 W 0 0 0 0 0 0 0 0 0 0 0 0 0 0 W 0 0 0 W 0 0 0 0 0 0 0 1 9 9 9 9 9 9 9 9 0 0 0 W 0 0 0 0 0 0 0 0 0 0 0 0 W 0 0 0 0 0 0 0 0 0 0 0 0 0 0 0 0 0 0 0 0 1 0 0 0 0 0 0 0 0 0 0 W 0 0 0 0 0 0 0 0 0 0 0 0 0 0 0 0 0 0 0 0 0 
1 0 0 0 0 0 0 0 0 0 0 0 0 0 0 0 0 0 3 0 0 W 0 0 0 0 0 0 0 0 0 0 0 0 0 0 0 0 0 0 0 W 0 0 0 0 0 0 0 0 0 0 0 W 0 0 0 0 0 0 0 0 1 2 0 W W 0 0 0 0 0 0 0 0 0 0 W W 0 0 0 0 0 0 0 W W 0 W W 0 0 0 0 0 0 0 0 0 0 0 0 0 0 W W 0 W W 0 0 0 0 0 0 0 W W 9 9 9 9 9 0 0 0 0 0 W W 0 0 0 0 0 0 0 0 0 0 0 W 0 0 0 0 0 0 0 0 0 0 0 W 0 0 0 0 0 0 1 2 0 0 0 0 0 0 0 0 0 0 0 W 0 0 0 0 0 0 0 0 0 0 0 0 0 0 0 0 0 0 0 0 0 
0 0 0 0 0 0 0 0 0 0 0 0 0 0 0 0 0 0 3 0 0 W 0 0 0 0 0 0 0 0 0 0 0 0 0 0 0 0 0 0 0 W W W 0 0 0 0 0 0 0 0 0 W 0 0 0 0 0 0 0 0 0 0 W W 0 0 0 0 0 0 0 0 0 0 0 0 W W W W W 0 0 0 W W W W W 0 0 0 0 0 0 0 0 0 0 0 0 0 0 W W W W W 0 0 0 W W W W W 1 9 9 9 9 0 0 0 0 0 0 0 W W 0 0 0 0 0 0 0 0 0 0 W 0 0 0 0 0 0 0 0 0 W W W 0 0 0 0 0 3 3 3 4 0 0 0 0 0 0 0 0 A 0 W 0 0 0 0 0 0 0 0 0 0 0 0 0 0 0 0 0 0 0 0 0 
0 0 0 0 0 0 0 0 0 0 0 0 0 0 0 0 0 0 3 1 0 W 0 0 0 0 0 0 0 0 0 0 0 0 0 0 0 0 A 0 0 0 0 W W W 0 0 0 0 0 0 0 W 0 0 0 0 0 0 0 0 0 W W 0 0 0 0 0 0 0 0 0 0 0 0 0 0 0 0 0 W W W W 0 0 0 0 W W W W W W W W W W W W W W W W 0 0 0 0 W W W W 0 0 0 0 1 9 9 9 0 0 0 0 0 0 0 0 0 W W 0 0 0 0 0 0 0 0 0 W 0 0 0 0 0 0 0 W W W 0 0 0 0 0 0 0 4 4 4 5 0 0 0 0 0 0 0 0 0 0 W 0 0 0 0 0 0 0 0 0 0 0 0 0 0 0 0 0 0 0 0 0 
0 1 0 0 0 0 0 0 0 0 0 0 0 0 0 0 0 3 4 2 W 0 0 0 0 0 0 0 0 0 0 0 0 0 0 0 0 0 0 0 0 0 0 0 0 0 0 0 0 0 0 0 0 0 A 0 0 0 0 0 0 0 W W 0 0 0 0 0 0 0 0 0 0 0 0 0 0 0 0 0 0 0 0 0 0 0 0 0 0 0 0 0 2 0 0 0 0 0 0 0 0 0 0 0 0 0 0 0 0 0 0 0 0 0 0 0 0 1 9 9 0 0 0 0 0 0 0 0 0 0 0 W W 0 0 0 0 0 0 0 0 0 A 0 0 0 0 0 0 0 0 0 0 0 0 0 0 0 0 5 5 5 6 0 0 0 0 0 0 0 0 0 0 0 W 0 0 0 0 0 0 0 0 0 0 0 0 0 0 0 0 0 0 0 0 
0 0 0 0 0 0 0 0 0 0 0 0 0 0 0 0 0 3 4 W 1 0 0 0 0 0 0 0 0 0 0 0 0 0 0 0 0 0 0 0 0 0 0 0 0 0 0 0 0 0 0 0 0 0 0 0 0 0 0 0 0 W W 0 0 0 0 0 0 0 0 0 0 0 0 0 0 0 0 0 0 0 0 0 0 0 0 0 0 0 0 0 0 0 0 0 0 0 0 0 0 0 0 0 0 0 0 0 0 0 0 0 0 0 0 0 0 0 1 9 9 0 0 0 0 0 0 0 0 0 0 0 0 W W 0 0 0 0 0 0 0 0 0 0 0 0 0 0 0 0 0 A 0 0 0 0 F 0 0 6 6 6 5 2 0 0 0 0 0 0 0 0 0 0 0 W 0 0 0 0 0 0 0 0 0 0 A 0 0 0 0 0 0 0 0 
0 0 0 0 0 0 0 0 0 0 0 W 0 0 0 0 3 4 W 2 1 0 0 0 0 0 0 0 W W 0 0 0 0 0 0 0 0 0 0 0 0 0 0 0 0 0 0 0 0 0 0 0 0 0 0 0 0 0 0 0 W 0 0 0 0 0 0 0 0 0 0 W W 0 0 0 0 0 0 0 0 0 0 0 0 0 0 0 0 0 0 0 0 0 0 0 0 0 0 0 0 0 0 0 0 0 0 0 A 0 0 0 0 0 0 0 0 1 2 0 0 W W 0 0 0 0 0 0 0 0 0 0 W 0 0 0 0 0 0 0 0 0 0 0 0 0 0 0 0 0 0 0 0 0 0 0 0 0 4 0 0 0 0 0 W W 0 0 0 0 0 0 0 0 0 W 0 0 0 0 0 0 W 0 0 0 0 0 0 0 0 0 0 0 
0 0 0 0 0 0 0 0 0 W W 0 0 0 0 3 3 2 W W 0 0 0 0 0 0 0 0 0 W 0 0 0 0 0 0 0 0 0 0 0 0 0 0 0 0 0 0 0 0 0 0 0 0 0 0 0 0 0 0 0 0 0 0 0 0 0 0 0 0 0 0 0 0 W 0 1 0 0 0 0 0 0 0 0 0 0 0 0 0 0 0 0 0 0 0 0 0 0 0 0 0 0 0 0 0 0 0 0 0 0 0 0 0 0 0 0 0 1 3 0 W 0 0 0 0 0 0 0 0 0 0 0 0 0 0 0 0 0 0 0 0 0 0 0 0 0 0 0 0 0 0 0 0 0 0 0 0 0 0 0 0 0 0 0 0 W 0 0 0 0 0 0 0 0 0 W W 0 4 0 0 0 0 0 W W 0 0 0 0 0 0 0 0 0 
0 0 0 0 0 0 W W W 0 0 0 0 3 4 3 2 1 0 W 0 0 0 M 0 0 0 0 0 W W 2 0 0 0 0 0 0 0 0 0 0 0 0 0 0 0 0 0 0 0 0 0 0 0 0 0 0 0 0 0 0 0 0 0 0 0 0 0 0 0 0 0 0 0 W 1 0 0 0 0 0 0 0 0 0 A 0 0 0 0 0 0 0 0 0 0 0 0 0 0 0 0 0 0 0 0 0 0 F 0 0 0 0 0 0 0 0 1 7 W 0 0 0 0 0 0 0 0 0 A 0 0 0 A 0 0 0 0 0 0 0 0 0 0 0 0 0 0 0 0 0 0 0 0 0 0 0 0 0 0 0 0 0 0 W W 0 0 0 0 0 M 0 0 0 W 0 2 3 0 0 0 0 0 0 0 W W W 0 0 0 0 0 0 
0 0 0 W W W 0 1 2 3 4 5 5 4 3 2 1 0 0 W 0 0 0 0 0 0 0 0 0 0 0 W W 0 0 0 0 0 0 0 0 M 0 0 0 0 0 0 0 0 0 0 0 0 0 0 0 0 0 0 0 0 0 0 0 0 0 0 A 0 0 0 0 0 0 0 W 0 0 0 0 0 0 0 0 0 0 0 0 0 0 0 0 0 0 0 0 0 0 0 0 0 0 0 0 0 0 0 0 0 0 0 0 0 0 0 0 1 2 W 0 0 0 0 0 0 0 0 0 A 0 0 0 0 A 0 0 0 0 0 0 0 0 0 0 0 0 0 0 0 0 0 0 0 M 0 0 0 0 0 0 0 0 W W 0 0 0 0 0 0 0 0 0 0 0 W 0 0 3 4 0 0 0 0 0 0 0 0 0 W W W 0 0 0 
W W W 0 0 0 0 0 2 3 4 5 5 4 3 2 1 0 0 0 W 0 0 0 0 0 0 0 0 0 0 0 U W W 0 0 0 0 0 0 0 0 0 A 0 0 0 0 0 0 0 0 0 0 0 0 0 0 0 0 0 W 0 0 0 0 0 0 0 0 0 0 0 0 0 0 W 0 0 0 0 0 0 0 0 0 0 0 0 0 0 0 0 0 0 0 0 0 0 0 0 0 0 0 0 0 0 0 0 0 0 0 0 0 0 0 1 W 0 0 0 0 0 0 0 0 0 A 0 0 0 0 W 0 0 0 0 0 0 0 0 0 0 0 0 0 0 0 0 0 0 0 0 0 0 0 0 0 0 0 W W 0 0 0 0 0 0 0 0 0 0 0 0 W 0 0 0 3 4 0 0 0 0 0 0 0 0 0 0 0 0 W W W 
0 0 0 0 0 0 0 0 2 3 4 5 4 3 2 1 0 0 0 0 W 0 0 0 0 0 0 0 0 0 0 0 0 U U W U 0 0 0 0 0 0 0 0 0 0 0 0 0 0 0 0 0 0 0 0 0 0 0 W W W W W 0 0 0 0 0 0 0 0 0 0 0 0 0 W 0 0 0 0 0 0 0 0 0 0 0 0 0 0 0 0 0 0 0 0 0 0 0 0 0 0 0 0 0 0 0 0 0 0 0 0 0 1 W 0 0 0 0 0 0 0 0 0 0 0 0 0 W W W W W 0 0 0 0 0 0 0 0 0 0 0 0 0 0 0 0 0 0 0 0 0 0 0 0 W 0 0 0 0 0 0 0 0 0 0 0 0 0 0 W 0 0 0 0 4 9 0 0 0 0 0 0 0 0 0 0 0 0 0 0 
0 0 0 0 0 0 0 0 1 2 3 4 4 3 2 1 0 0 0 0 W W W 0 0 0 0 0 0 0 0 0 0 U U W W W 0 0 0 0 0 0 0 0 0 0 0 0 0 0 0 0 0 0 0 1 W W W 0 0 0 0 W W 0 0 0 0 0 0 0 0 0 0 0 0 W W 0 0 0 0 0 0 0 0 0 0 0 0 0 0 0 A 0 0 0 0 0 0 0 0 0 0 0 0 0 0 0 0 0 0 W W 0 0 0 0 0 0 0 0 0 0 0 0 W W 0 0 0 0 W W W 0 0 0 0 0 0 0 0 0 0 0 0 0 0 0 0 0 0 0 0 W W W 0 0 0 0 0 0 0 0 0 0 0 0 W W W 0 0 0 0 4 9 10 0 0 0 0 0 0 0 0 0 0 0 0 0 
0 0 0 0 0 0 0 0 0 3 4 5 4 3 2 1 0 0 0 0 0 0 0 W W 0 0 0 0 0 0 0 0 U U U W W W W W W W W W W 0 0 0 0 0 0 0 0 1 2 W W W 5 0 0 0 0 0 0 0 W 0 0 0 0 0 0 0 0 0 0 0 W W 0 0 0 0 0 0 0 0 0 W W 0 0 0 0 0 0 0 0 0 0 0 0 W W 0 0 0 0 0 0 0 0 1 W W 0 0 0 0 0 0 0 0 0 0 0 W 0 0 0 0 0 0 0 0 W W W 0 0 0 0 0 0 0 0 0 0 W W W W W W W W W W 0 0 0 0 0 0 0 0 0 A 0 W W 0 0 0 0 0 0 0 4 7 7 9 10 0 0 0 0 0 0 0 0 0 A 0 
0 0 0 0 0 0 0 0 2 3 4 4 3 2 1 0 0 0 0 0 0 0 0 0 0 A 0 0 0 0 0 0 0 0 2 2 1 2 0 0 0 0 0 0 W W W 0 0 0 0 0 0 W W W W U U 5 0 0 0 0 0 0 0 W 0 0 0 0 0 0 0 0 0 0 0 0 W W 0 0 0 0 0 W W W 0 0 0 0 0 0 0 0 0 0 0 0 0 0 0 0 W W W 0 0 0 0 0 W W 2 0 0 0 0 0 0 0 0 0 0 0 W 0 0 0 0 0 0 0 0 0 0 W W W W 0 0 0 0 0 0 W W W 0 0 0 0 0 0 0 0 0 0 0 A 0 0 0 0 0 0 0 0 A 0 0 0 0 0 0 0 0 0 6 7 7 10 10 0 0 0 0 0 0 0 0 0 
0 0 0 0 0 0 0 0 2 3 4 5 4 3 2 1 0 0 0 0 0 0 0 0 0 0 0 0 0 0 0 0 0 0 0 0 0 0 0 0 0 0 0 0 0 0 0 0 0 0 0 0 0 1 W U U U U U 5 0 0 0 0 0 0 W 0 0 0 0 0 0 0 0 0 0 0 W W W W W W W W 0 0 0 0 0 0 0 0 0 0 0 0 0 0 0 0 0 0 0 0 0 0 W W W W W W W W 0 0 0 0 0 0 0 0 0 0 0 W 0 0 0 0 0 0 0 0 0 0 0 0 W 0 0 0 0 0 0 0 0 0 0 0 0 0 0 A A 0 0 0 0 0 0 0 0 0 0 0 0 0 0 0 0 0 0 0 0 0 0 0 0 0 5 6 7 10 0 0 0 0 0 0 0 0 0 
0 0 0 0 0 0 0 0 3 4 5 6 4 W W W W W 0 0 0 0 0 0 0 0 0 0 0 0 0 0 0 0 0 0 0 0 0 0 0 0 0 0 0 0 0 0 0 0 0 0 1 U U U U U U U U 5 0 0 0 0 0 0 W 0 0 0 0 0 0 0 0 0 W 0 0 0 0 W W 0 0 0 0 1 0 0 0 0 0 0 0 0 0 0 0 0 0 0 0 0 0 0 0 0 0 W W 0 0 1 0 W 0 0 0 0 0 0 0 A 0 W 0 0 0 0 0 0 0 0 0 0 0 A 0 0 0 0 0 0 0 0 0 0 0 0 0 0 0 0 0 0 0 0 0 0 0 0 0 0 0 0 0 0 0 0 0 0 0 0 0 0 W W W W W 0 5 6 7 0 0 0 0 0 0 0 0 0 
0 0 0 0 0 0 0 2 3 4 5 5 W W W W W 0 0 0 0 0 0 0 0 0 0 0 0 0 0 0 0 0 0 0 0 0 0 0 0 0 0 0 0 0 0 0 0 0 0 1 U U U U U U U U U U U 5 0 0 0 0 0 0 0 0 0 0 0 0 W W 0 0 0 0 0 0 0 0 0 0 2 2 0 0 0 0 0 0 0 0 A 0 0 0 0 0 0 A 0 0 0 0 0 0 0 0 0 0 0 0 W W 0 0 0 0 0 0 0 0 0 0 0 0 0 A 0 0 0 0 0 0 0 0 0 0 0 0 0 0 0 0 0 0 0 0 0 0 0 0 0 0 0 0 0 0 0 0 0 0 0 0 0 0 0 0 0 0 0 0 0 W W W W W 4 5 6 10 0 0 0 0 0 0 0 0 
0 0 0 0 0 0 0 3 3 3 4 W 5 4 3 2 1 0 0 0 0 0 0 0 0 0 0 W W 0 0 0 0 0 0 0 0 0 0 0 0 0 0 0 0 0 0 0 0 0 0 0 0 0 1 U U U U U U U 9 8 8 1 1 1 0 1 1 0 0 0 0 W 0 0 0 0 A 0 0 0 0 0 0 0 0 0 0 0 0 0 0 0 0 0 0 0 0 0 0 0 0 0 0 0 0 0 0 0 0 0 0 0 0 0 0 0 W 0 0 0 0 0 0 0 0 0 0 0 0 0 0 0 0 0 0 0 0 0 0 0 0 0 0 0 0 0 0 0 0 0 0 0 0 0 0 0 0 0 0 0 0 0 0 W W 0 0 0 0 0 0 0 0 0 0 0 0 0 0 0 W 5 6 7 0 0 0 0 0 0 0 0 
0 0 0 0 0 0 0 0 1 2 W 3 4 4 3 2 1 0 0 0 0 0 0 0 0 0 0 0 0 W W W W W W 0 0 0 0 0 0 0 0 1 2 0 0 0 0 0 0 0 0 0 0 0 1 7 8 U U 9 8 1 1 0 0 0 0 0 0 0 0 0 0 0 0 0 0 0 0 0 0 0 0 0 0 0 0 0 0 0 0 0 0 0 0 0 0 0 0 0 0 0 0 0 0 0 0 0 0 0 0 0 0 0 0 0 0 0 0 0 0 0 0 0 0 0 0 0 0 0 0 0 0 0 0 0 0 0 0 0 0 0 0 0 0 0 0 1 0 0 0 0 0 0 0 0 0 0 0 W W W W W W 0 0 0 0 0 0 0 0 0 0 0 0 0 0 0 0 0 0 W 5 3 3 0 0 0 0 0 0 0 
0 0 0 0 0 0 0 W W W 1 2 3 4 4 3 2 1 0 0 0 0 0 0 0 0 0 0 0 0 0 0 0 0 W 0 0 0 0 0 0 0 0 0 0 0 0 0 0 0 0 0 0 0 0 W W W W 7 8 8 1 0 0 0 0 0 0 0 0 0 0 0 0 0 0 0 0 0 0 0 0 0 0 0 0 0 0 0 0 0 0 0 0 0 0 0 0 0 0 0 0 0 0 0 0 0 0 0 0 0 0 0 0 0 0 0 0 0 0 0 A 0 0 0 0 0 0 0 0 0 0 0 0 0 0 W W W W 0 0 0 0 0 0 0 1 0 0 0 0 0 0 0 0 0 0 0 0 W 0 0 0 0 0 0 0 0 0 0 0 0 0 0 0 0 0 0 0 0 0 0 0 4 W W W 1 0 0 0 0 0 0 
0 0 0 0 0 W W W W 0 0 1 2 3 5 4 3 2 1 0 0 0 0 0 0 0 0 0 0 0 0 0 0 0 W W 0 0 0 0 0 0 0 0 0 0 0 0 0 0 0 0 0 0 0 W 0 0 W W W W 0 0 0 0 0 0 0 0 0 0 0 0 0 0 0 0 0 0 0 0 0 0 0 0 0 0 0 0 0 0 0 0 0 0 0 0 0 0 0 0 0 0 0 0 0 0 0 0 0 0 0 0 0 0 0 0 0 0 0 0 A 0 0 0 0 0 0 0 0 0 0 0 W W W W 0 0 W 0 0 0 0 0 0 0 0 0 0 0 0 0 0 0 0 0 0 0 W W 0 0 0 0 0 0 0 0 0 0 0 0 0 0 0 A 0 0 0 0 0 0 0 0 2 W W W W 0 0 0 0 0 
0 0 0 0 0 0 0 0 0 0 0 0 1 2 4 7 8 4 3 2 1 0 0 0 0 0 0 0 0 0 0 0 0 0 0 W 0 0 0 0 0 0 0 0 W 0 0 0 0 0 0 0 0 0 W 0 0 0 1 5 6 W W W 0 0 0 0 0 0 0 0 0 0 0 0 0 0 0 0 0 0 0 0 0 0 0 0 0 0 0 0 0 0 0 0 0 0 0 0 0 0 0 0 0 0 0 0 0 0 0 0 0 0 0 0 0 0 0 0 0 0 0 0 0 0 0 0 0 0 0 0 W W W 0 0 0 0 0 0 W 0 0 0 0 0 0 0 0 0 W 0 0 0 0 0 0 0 0 W 0 0 0 0 0 0 0 0 0 0 0 0 0 0 0 0 0 0 0 0 0 0 0 0 2 1 0 0 0 0 0 0 0 0 0 
0 0 0 0 0 0 0 0 0 0 0 0 1 2 3 6 9 3 3 3 0 3 W 1 0 U 0 0 0 0 0 0 0 0 0 0 A 0 0 0 0 0 0 0 W W 0 0 0 0 0 0 0 W W 0 0 0 0 1 1 0 0 0 0 0 0 0 0 0 0 0 0 0 0 0 0 0 0 0 0 0 0 0 0 0 0 0 0 0 0 0 0 0 0 0 0 0 0 0 0 0 0 0 0 0 0 0 0 0 0 0 0 0 0 0 0 0 0 0 0 0 A 0 0 0 0 0 0 0 0 0 0 0 0 0 0 0 0 0 0 W W 0 0 0 1 0 0 0 W W 0 0 0 0 0 0 0 0 0 0 1 2 0 0 0 0 0 0 0 0 0 W 0 0 0 0 0 0 0 0 0 0 0 1 0 0 0 0 0 0 0 0 0 0 
0 0 0 0 0 0 0 0 0 0 0 0 0 1 2 3 3 0 0 0 0 0 W 0 3 3 6 0 0 0 0 0 0 0 0 0 0 0 0 0 0 0 0 0 0 W W W W W W W W W 0 0 0 0 0 1 0 0 0 0 0 0 0 0 0 0 0 0 0 0 0 0 0 0 0 0 0 0 0 0 0 0 W 0 0 0 0 0 0 0 0 0 0 0 0 0 0 0 0 0 0 0 0 0 0 W 0 0 0 0 0 0 0 0 0 0 0 0 A 0 0 0 0 0 0 0 0 0 0 0 0 0 0 0 0 0 0 0 W W W W W W W W W 0 0 0 0 0 0 0 0 0 0 0 0 0 0 0 0 0 0 0 0 0 0 W 0 0 0 0 0 0 0 0 0 0 0 0 0 0 0 0 0 0 0 0 0 0 
0 0 0 0 0 0 0 0 0 0 0 0 W 1 2 0 0 0 0 0 0 0 W 0 0 0 3 0 0 0 0 0 0 0 0 0 0 0 0 0 0 0 0 0 0 0 W W W W W W W 0 0 0 0 0 0 1 0 0 0 0 0 0 0 0 0 0 0 0 0 0 0 0 0 0 0 0 0 0 0 0 0 0 W 0 0 0 0 0 0 0 0 0 0 0 0 0 0 0 0 0 0 0 0 0 0 W 0 0 0 0 0 0 0 0 0 0 0 0 0 0 0 0 0 0 0 0 0 0 0 0 0 0 0 0 0 0 0 0 0 W W W W W W W 0 0 0 0 0 0 0 0 0 0 0 0 0 0 0 0 0 0 0 0 0 0 0 W 0 0 0 0 0 0 0 0 0 W 1 0 0 0 0 0 0 0 0 0 0 0 
0 0 0 0 0 0 0 0 0 0 0 0 W 1 0 0 0 0 0 0 0 0 W 0 0 0 0 0 0 0 0 0 0 0 0 0 0 0 0 0 0 0 0 0 0 0 0 0 0 0 0 A 0 0 0 0 0 0 0 0 0 0 0 0 0 0 0 0 A 0 0 0 0 0 0 W 0 0 0 0 0 0 0 0 0 W 0 0 0 0 0 0 A 0 0 0 0 0 0 0 0 2 1 0 0 0 0 0 0 0 W 0 0 0 0 0 0 0 0 0 W 0 0 0 0 0 0 0 0 0 0 0 0 0 0 0 0 0 0 0 0 0 0 0 0 0 0 0 0 0 0 0 0 0 0 0 0 0 0 0 0 0 0 0 0 0 0 0 0 0 0 0 0 W 0 0 0 0 0 0 0 0 0 W 0 0 0 0 0 0 0 0 0 0 0 0 
0 0 0 0 0 0 0 0 0 0 0 W W 0 0 0 0 0 0 0 0 0 W 0 0 0 0 0 0 0 0 0 0 W 0 0 0 0 0 0 0 0 0 0 0 0 0 0 0 0 0 0 0 0 0 0 0 0 0 1 0 0 0 0 0 W 0 0 0 0 0 0 0 0 0 W 0 0 0 0 A 0 0 0 0 0 0 0 0 0 0 0 0 0 0 0 0 0 0 0 1 1 0 0 0 0 0 0 0 0 0 0 0 0 0 0 0 0 0 0 W 0 0 0 0 0 0 0 0 0 W 0 0 0 0 0 0 0 0 0 0 0 0 0 0 0 0 0 0 0 0 0 0 A 0 0 0 0 0 0 0 0 W 0 0 0 0 0 0 0 0 0 0 W 0 0 0 0 0 0 0 0 0 W W 0 0 0 0 0 0 0 0 0 0 0 
0 0 0 0 A 0 0 0 0 0 0 W 0 0 0 0 0 0 0 0 0 0 W 0 0 0 0 0 0 0 0 0 0 W W 0 0 0 0 0 0 0 0 0 0 0 0 0 0 0 0 0 0 0 0 0 0 0 0 1 0 0 0 0 0 W 0 0 0 0 0 0 0 0 0 W 0 0 0 0 0 0 0 0 0 0 0 0 0 0 0 0 0 0 0 0 0 0 0 0 1 1 0 0 0 0 0 0 0 0 0 0 0 0 0 0 0 0 0 0 W 0 0 0 0 0 0 0 0 0 W 0 0 0 0 0 0 0 0 0 0 0 0 0 0 0 0 0 0 0 0 0 0 0 0 0 0 0 0 0 0 W W 0 0 0 0 0 0 0 0 0 0 W 0 0 0 0 0 0 0 0 0 0 W 0 0 0 0 0 0 0 0 0 0 0 
0 0 0 0 0 0 0 0 0 0 0 W 0 0 0 0 0 0 0 0 0 0 W 0 0 0 0 0 0 0 0 0 0 0 W 0 0 0 0 0 0 0 0 0 0 0 0 0 0 0 0 0 0 0 0 0 0 0 0 0 0 0 0 0 W 0 0 0 0 0 0 0 0 0 0 W 0 0 0 0 0 0 0 0 0 0 0 0 0 0 0 0 0 0 0 0 0 0 0 0 0 0 0 0 0 0 0 0 0 0 A 0 0 0 0 0 0 0 0 0 W 0 0 0 0 0 0 0 0 0 0 W 0 0 0 0 0 0 0 0 0 0 0 0 0 0 0 0 0 0 0 0 0 0 0 0 0 0 0 0 0 W 0 0 0 0 0 0 0 0 0 0 0 W 0 0 0 0 0 0 0 0 0 0 W 0 0 0 0 0 0 0 0 0 0 0 
0 W W 0 0 0 0 0 0 0 0 W 0 0 0 0 0 0 0 0 0 0 W W 0 0 0 0 0 5 0 0 0 0 W W 0 0 0 0 0 1 3 0 0 0 0 0 0 0 0 0 0 0 W 0 0 0 0 0 0 0 0 W W 0 0 0 0 0 0 0 0 0 0 W 0 0 0 0 0 0 0 0 0 0 0 0 0 0 0 0 0 0 0 0 0 0 0 0 0 0 0 0 0 0 0 0 0 0 0 0 0 0 0 0 0 0 0 0 W 0 0 0 0 0 0 0 0 0 0 W W 0 0 0 0 0 0 0 0 W 0 0 0 0 0 0 0 0 0 0 0 0 0 0 0 0 0 0 W W 0 0 0 0 0 0 0 0 0 0 W W 0 0 0 0 0 0 0 0 0 0 W 0 0 0 0 0 0 0 A W W 0 
W 0 0 0 0 0 0 0 0 0 W W 0 0 0 0 0 0 0 0 A 0 W W 0 0 0 0 0 5 9 8 0 0 W 0 0 0 0 1 4 5 6 0 0 0 0 0 0 0 0 0 0 0 W 0 0 0 0 0 0 0 W W 0 0 0 0 0 0 0 0 0 0 0 0 W 0 0 0 0 0 0 0 0 0 W 0 0 0 0 0 0 0 0 0 0 0 0 0 0 0 0 0 0 0 0 0 0 W 0 0 0 0 0 0 0 0 0 W 0 0 0 0 0 0 0 0 0 0 0 0 W W 0 0 0 0 0 0 A W 0 0 0 0 0 0 0 0 0 0 0 0 0 0 0 0 0 0 0 W 0 0 0 0 0 0 0 0 0 0 W W 0 0 0 0 0 0 0 0 0 0 W W 0 0 0 0 0 0 0 0 0 W 
0 0 0 0 0 0 0 0 0 0 W 0 0 0 0 0 0 0 0 0 0 0 0 W W 0 0 0 0 5 5 8 8 7 W 6 1 4 5 6 6 6 7 W 0 0 0 0 0 0 0 0 0 W 0 0 0 0 0 0 0 0 0 0 0 0 0 0 0 0 0 0 0 0 0 0 W 0 0 0 0 0 0 0 0 W W 0 0 0 0 0 0 0 0 0 0 0 0 0 0 0 0 0 0 0 0 0 0 W W 0 0 0 0 0 0 0 0 W 5 0 0 0 0 0 0 0 0 0 0 0 0 0 0 0 0 0 0 0 0 0 W 0 0 0 0 0 0 0 0 0 W 0 0 0 0 0 0 0 0 W 0 0 0 0 0 A 0 0 0 W W 0 0 0 0 0 0 0 0 0 0 0 0 W 0 0 0 0 0 0 0 0 0 0 
0 0 0 0 0 0 0 0 0 0 W 1 0 0 0 0 0 0 0 0 0 0 0 0 W 0 0 0 0 0 0 5 5 W 8 3 3 3 2 3 3 3 4 5 W W 0 0 0 0 0 0 W 0 0 0 0 0 0 0 0 0 0 0 0 0 0 0 0 0 0 0 0 0 0 0 W 0 0 0 0 0 0 0 W W 0 0 0 0 0 0 0 0 0 0 0 0 0 0 0 0 0 0 0 0 0 0 0 0 W W 0 0 0 0 0 0 0 W 9 0 0 0 0 0 0 0 0 A 0 0 0 0 0 0 0 0 0 0 0 0 0 W 0 0 0 0 0 0 W W 0 0 0 0 0 0 0 0 0 0 W 0 0 0 0 0 0 0 0 W 0 0 0 0 0 0 0 0 0 0 0 0 0 W 0 0 0 0 0 0 0 0 0 0 
0 0 0 0 0 0 0 0 0 0 W 0 0 0 0 0 0 0 0 0 0 0 0 0 W W 0 0 0 0 0 0 0 W 3 2 2 2 1 2 2 2 3 3 4 3 W W W W W W W 0 0 0 0 0 0 0 0 0 0 0 0 0 0 0 0 0 0 0 0 0 0 0 W 0 0 0 0 0 0 W W 0 0 0 0 0 0 0 0 W W 0 0 0 0 0 0 W W 0 0 0 0 0 0 0 0 W W 0 0 0 0 0 9 W 9 0 0 0 0 0 0 0 0 0 0 0 0 0 0 0 0 0 0 0 0 0 0 W W W W W W W 0 0 0 0 0 0 0 0 0 0 0 0 W 0 0 0 0 0 0 0 W W 0 0 0 0 0 0 0 0 0 0 0 0 0 W 0 0 0 0 0 0 0 0 0 0 
0 0 0 0 0 0 0 0 0 0 0 W 0 0 0 0 0 0 0 0 0 0 0 0 0 W 0 0 0 0 0 0 0 W 2 1 1 1 0 1 1 1 2 2 3 4 0 0 0 0 0 W 0 0 0 0 0 0 0 0 0 0 0 1 2 0 0 0 0 0 0 0 0 0 0 0 W 0 0 1 0 3 0 W 0 0 0 0 0 0 A 0 0 W 0 0 0 0 0 0 0 0 W 0 0 0 0 0 0 0 0 0 W 0 0 0 0 0 9 W 9 0 0 0 0 0 0 0 0 0 0 0 0 0 0 0 0 0 0 0 0 0 0 0 W 0 0 0 0 0 0 0 0 0 0 0 0 0 0 0 0 0 W 0 0 0 0 0 0 0 W 0 0 0 0 0 0 0 0 0 0 0 0 0 W 0 0 0 0 0 0 0 0 0 0 0 
0 0 1 0 0 0 0 0 0 0 0 W 0 0 0 0 0 0 0 0 0 0 0 0 0 W W 0 0 0 0 0 W 0 0 0 0 0 0 0 0 0 1 1 2 0 0 0 0 0 0 0 0 A 0 0 0 0 0 0 0 0 0 0 1 0 0 0 0 0 0 0 W W W W W 0 0 0 1 2 0 W W 0 0 0 0 0 0 0 W W 0 0 0 0 A 0 0 0 W W 0 0 0 0 0 0 0 W W 0 0 0 0 9 9 W W W W W 0 0 0 0 0 0 0 0 0 0 0 0 0 0 0 0 0 0 0 0 0 0 0 2 2 0 0 0 0 0 0 0 0 A 0 0 0 0 0 W 0 0 0 0 0 W W 0 0 0 0 0 0 0 0 0 A 0 0 0 W 0 0 0 0 0 0 0 0 0 0 0 