
U U U U U U U U U U U U U U U U U U U U U U U U U U U U U U U U U U U U U U U U U U U U U U U U U U U U U U U U U U U U U U U U U U U U U U U U U U U U U U U U U U U U W U U U U U U U U U U U U U U U U U U U U U U U U U U W U U U U U U U U U U U U W U U U U U U U U U U U U U U U U U U U U U U U U U U U U U U U U U U U U U U W U U U U W W U U U U U U U U U U U U U U U U U U U U U U U U U U 
U U U U U U U U U U U U U U U U U U U U U U U U U U U U U U U U U U U U U U U U U U U U U U U U U U U U U U U U U U U U U U U U U U U U U U U U U U U U U U U U U U U U U U U U U U U U U U U U U U U U U U U U U U U U U U U W U U U U U U U U U U U U U U U U U U U U U U W W U U U U U U U U U U U U U U U U U U U U U U U U U U U W W U U U U U U U U U U U U U U U U U U U U U U U U U U U U U U U 
U U U U U U U U U U U U U U U U U U U U U U U U U U U U U U U U U U U U U U U U U U U U U U U U U U U U U U U U U U U U U U U U U U U U U U U U U U U U U U U U U U U U U U U U U U U U U U U U U U U U U U U U U U U U U U W U U U U U U U U U U U U U U U U U U U U U U U U W W W W U U U U U U U U U U U U U U U U U U U U U U U U W U U U U U U U U U U U U U U U U U U U U U U U U U U U U U U U U 
U U U U U U U U U U U U U U U U U U U U U U U U U U U U U U U U U U U U U U U U U U U U U U U U U U U U U U U U U U U U U U U U U U U U U U U U U U U U U U U U U U U U U U U U U U U U U U U U U U U U U U U U U U U U U U W U U U U U U U U U U U U U U U U U U U U U U U U U U U W W W W U U U U U U U U U U U U U U U U U U U U U W U U U U U U U U U U U U U U U U U U U U U U U U U U U U U U U U 
U U U U U U U U U U U U U U U U U U U U U U U U U U U U U U U U U U U U U U U U U U U U U U U U U U U U U U U U U U U U U U U U U U U U U U U U U U U U U U U U U U U U U U U U U U U U U U U U U U U U U U U U U U U U U W W U U U U U U U U U U U U U U U U U U U U U U U U U U U U U W W W U U U U U U U U U U U U U U U U U U U U U U U U U U U U U U U W U U U U U U U U U U U U U U U U U U U U U 
U U U U U U U U U U U U U U U U U U U U U U U U U U U U U U U U U U U U U U U U U U U U U U U U U U U U U U U U U U U U U U U U U U U U U U U U U U U U U U U U U U U U U U U U U U U U U U U U U U U U U U U U U U U U U W U U U U U U U U U U U U U U U U U U U W U U U U U 5 6 7 8 9 10 U W U U U U U U U 0 0 0 0 0 0 0 U U U U U U U U U U U U 0 0 0 0 0 W 0 U U U U U U U U U U U U U U U U U U U U 
U U U U U U U U U U U U U U U U U U U U U U U U U U U U U U U U U U U U U U U U U U U U U U U U U U U U U U U U U U U U U U U U U U U U U U U U U U U U U U U U U U U U U U U U U U U U U U U U U U U U U U U U U U U U W W U U U U U U U W W U U U U U U U U 0 0 W W 0 0 0 1 2 3 4 5 6 7 8 W 10 U U U U 0 0 0 0 0 0 W 0 0 0 0 U U U U U U U U 0 0 0 0 0 0 0 W 0 0 0 U U U U U U U U U U U U U U U U U U 
U U U U U U U U U U U U U U U U U U U U U U U U U U U U U U U U U U U U U U U U U U U U U U U U U U U U U U U U U U U U U U U U U U U U U U U U U U U U U U U U U U U U U U U U U U U U U U U U U U U U U U U U U U U U W W U U U W W W W W U U U U U U U 0 0 0 0 0 W W 0 0 0 0 1 2 3 4 5 6 W 8 9 10 U 0 0 0 0 0 W W W 0 0 0 0 0 U U U U U U 0 0 0 0 0 0 0 0 W 0 0 0 0 U U U U U U U U U U U U U U U U U 
U U U U U U U U U U U U U U U U U U U U U U U U U U U U U U U U U U U U U U U U U U U U U U U U U U U U U U U U U U U U U U U U U U U U U U U U U U U U U U U U U U U U U U U U U U U U U U U U U U U U U U U U U U U U U U W W W W U U U U U U U U U 9 0 0 0 0 0 0 0 W W 0 0 0 0 1 2 3 4 5 W 7 8 9 0 0 0 0 W W W 0 0 0 0 0 0 0 0 U U U U 0 0 0 0 0 0 0 0 0 W 0 0 0 0 0 U U U U U U U U U U U U U U U U 
U U U U U U U U U U U U U U U U U U U U U U U U U U U U U U U U U U U U U U U U U U U U U U U U U U U U U U U U U U U U U U U U U U U U U U U U U U U U U U U U U U U U U U U U U U U U U U U U U U U U U U U U U U U U U U U U U U U U U U U U U U 7 0 0 0 0 0 0 0 0 0 W W 0 0 0 0 1 2 3 4 5 6 7 8 0 0 0 0 0 0 0 0 0 0 0 0 0 0 0 2 U U U 0 0 0 0 0 0 0 0 0 0 W 0 0 0 0 U U U U U U U U U U U U U U U U 
U U U U U U U U U U U U U U U U U U U U U U U U U U U U U U U U U U U U U U U U U U U U U U U U U U U U U U U U U U U U U U U U U U U U U U U U U U U U U U U U U U U U U U U U U U U U U U U U U U U U U U U U U U U U U U U U U U U U U U U U U 5 5 0 0 0 0 0 0 0 0 0 0 W W 0 0 0 1 2 3 4 5 6 7 0 0 0 0 0 0 0 0 0 0 0 0 0 0 0 0 0 U U 0 0 0 0 0 0 0 0 0 0 0 0 W 0 0 0 0 U U U U U U U U U U U U U U U 
U U U U U U U U U U U U U U U U U U U U U U U U U U U U U U U U U U U U U U U U U U U U U U U U U U U U U U U U U U U U U U U U U U U U U U U U U U U U U U U U U U U U U U U U U U U U U U U U U U U U U U U U U U U U U U U U U U U U U U U U 5 4 W W 0 0 0 0 0 0 0 0 0 0 W 0 0 0 0 1 2 3 4 5 6 0 0 0 0 0 0 0 0 0 0 0 0 0 0 0 0 0 2 9 0 0 W W 0 0 0 0 0 0 0 0 0 W 0 0 0 U U U U U U U U U U U U U U U 
U U U U U U U U U U U U U U U U U U U U U U U U U U U U U U U U U U U U U U U U U U U U U U U U U U U U U U U U U U U U U U U U U U U U U U U U U U U U U U U U U U U U U U U U U U U U U U U U U U U U U U U U U U U U U U U U U U U U U U U 5 2 W 0 0 0 0 0 0 0 0 0 0 0 0 0 0 0 0 0 1 2 3 4 5 6 0 0 0 0 0 0 0 0 0 0 0 0 0 0 0 0 0 2 4 0 0 W 0 0 0 0 0 0 0 0 F W W 0 0 0 U U U U U U U U U U U U U U U 
U U U U U U U U U U U U U U U U U U U U U U U U U 7 8 9 10 W W U U U U U U U U U U U U U U U U U U U U U U U U U U U U U U U U U U U U U U U U U U U U U U U U U U U U U U U U U U U U U U U U U U U U U U U U U U U U U U U U U U U U U U U U 2 W 1 0 0 0 0 0 0 0 0 0 0 0 0 0 0 0 0 0 1 2 3 0 0 0 0 0 0 0 0 0 0 A 0 0 0 0 0 0 0 0 0 0 4 0 W W 0 0 0 0 0 M A 0 0 W 0 0 0 0 0 U U U U U U U U U U U U U U 
U U U U U U U U U U U U U U U U U U U 0 U 6 6 6 6 6 6 6 7 8 9 W W U U U U U U U U U U U U U U U U U U U U U U U U U U U U U U U U U U U U U U U U U U U U U U U U U U U U U U U U U U U U U U U U U U U U U U U U U U U U U U U U U U U U U 2 W 0 0 0 0 0 0 0 0 0 A 0 0 0 0 0 0 0 0 0 0 0 0 0 0 0 0 0 0 0 0 0 0 0 0 M 0 0 0 0 0 0 0 2 W W 0 0 0 0 0 0 0 0 0 0 0 W 0 0 0 0 0 U U U U U U U U U U U U U U 
U U U U U U U U U U U U U U U U 0 0 0 0 W 0 0 1 2 3 4 5 6 6 7 8 9 W W U U U U U U U U U U U U 1 2 3 4 5 6 U U U U U U U U U W U U U U U U 0 0 1 2 3 4 U U U U U U U U U U U U U U U U U 0 1 0 1 2 3 4 5 6 7 8 9 U U U U U U U U U U U U U U W 0 0 0 0 0 0 0 0 0 0 0 0 0 0 W 0 0 0 0 0 0 0 0 0 0 0 0 0 0 0 0 0 0 0 0 0 0 0 0 0 0 0 W W 3 0 0 0 0 0 0 0 0 0 0 0 W 0 0 0 0 0 0 U U U U U U U U U U U U U U 
U U U U U U U U U U U U U U 0 0 0 0 0 0 W 0 0 0 0 1 2 3 4 5 6 7 8 9 10 W U U U U U 1 1 0 0 0 0 0 0 0 1 2 0 0 0 0 0 0 0 0 W W W W W 0 0 0 0 0 0 0 0 0 0 0 0 0 W 0 0 0 0 0 0 1 2 3 4 0 0 0 0 0 0 0 0 0 1 2 3 0 0 0 0 0 0 0 0 0 0 0 0 1 2 3 4 W 0 0 0 0 0 0 0 0 0 0 0 0 0 W W W W W 0 0 0 0 0 0 0 0 0 0 0 0 0 0 0 0 0 0 0 0 0 0 0 0 W 0 2 3 0 0 0 0 0 0 0 0 A 0 0 W 0 0 0 0 0 0 U U U U U U U U U U U U U U 
U U U U U U U U U U U U U 0 0 0 0 0 0 0 W W W 0 0 0 1 2 3 4 5 6 7 8 9 W W W U 1 1 0 0 0 0 0 0 0 0 0 0 0 0 0 0 0 0 0 W W W 0 0 0 0 W W 0 0 0 0 0 0 0 0 0 0 0 0 W W 0 0 0 0 0 0 0 0 0 0 0 0 0 0 0 0 0 0 0 0 0 0 0 0 0 0 0 0 0 0 0 0 0 0 W W 1 0 0 0 0 0 0 0 0 0 0 0 W W 0 0 0 0 W W W 0 0 0 0 0 0 0 0 0 0 0 0 0 0 0 0 0 0 0 0 W W W 1 2 3 1 0 0 0 0 0 0 0 0 W W W 0 0 0 0 0 0 U U U U U U U U U U U U U U 
U U U U U U U U U U U U 0 0 0 0 0 0 0 0 0 0 0 W W 0 0 1 2 3 4 5 7 8 9 9 W W W W W W W W W W 0 0 0 0 0 0 0 0 0 0 W W W 0 0 0 0 0 0 0 0 W 0 0 0 0 0 0 0 0 0 0 0 W W 0 0 0 0 0 0 0 0 0 W W 0 0 0 0 0 0 0 0 0 0 0 0 W W 0 0 0 0 0 0 0 0 0 W W 0 0 0 0 0 0 0 0 0 0 0 W 0 0 0 0 0 0 0 0 W W W 0 0 0 0 0 0 0 0 0 0 W W W W W W W W W W 0 2 4 3 1 0 0 0 0 0 0 W W 0 0 0 0 0 0 0 0 0 U U U U U U U U U U U U U U 
U U U U U U U U U U U U 0 0 0 0 0 0 0 0 0 0 0 0 0 0 0 1 2 3 4 5 6 7 8 8 8 1 0 0 0 0 0 0 W W W 0 0 0 0 0 0 W W W W 0 0 0 0 0 0 0 0 0 0 W 0 0 0 0 0 0 0 0 0 0 0 0 W W 0 0 0 0 0 W W W 0 0 0 0 0 0 0 0 0 0 0 0 0 0 0 0 W W W 0 0 0 0 0 W W 0 0 0 0 0 0 0 0 0 0 0 0 W 0 0 0 0 0 0 0 0 0 0 W W W W 0 0 0 0 0 0 W W W 0 0 0 0 0 0 0 0 1 2 4 3 1 0 0 0 0 0 0 0 0 0 0 0 0 0 0 0 0 0 U U U U U U U U U U U U U U 
U U U U U U U U U U U 0 0 0 0 0 0 0 0 0 0 0 0 0 0 0 0 0 1 2 3 4 5 7 8 7 7 0 0 0 0 0 0 0 0 0 0 0 0 0 0 0 0 0 W 0 0 0 0 0 0 0 0 0 0 0 0 W 0 0 0 0 0 0 0 0 0 0 0 W W W W W W W W 0 0 0 0 0 0 0 0 0 0 0 0 0 0 0 0 0 0 0 0 0 0 W W W W W W W W 0 0 0 0 0 0 0 0 0 0 0 W 0 0 0 0 0 0 0 0 0 0 0 0 W 0 0 0 0 0 0 0 0 0 0 0 0 0 0 0 0 0 1 2 6 4 3 2 1 0 0 0 0 0 0 0 0 0 0 0 0 0 0 0 U U U U U U U U U U U U U U U 
U U U U U U U U U U U 0 0 W W W W W 0 0 0 0 0 0 0 0 0 0 1 2 3 4 5 7 7 6 1 0 0 0 0 0 0 0 0 0 0 0 0 0 0 0 0 0 0 0 0 0 0 0 0 0 0 0 0 0 0 0 W 0 0 0 0 0 0 0 0 0 W 0 0 0 0 W W 0 0 0 0 0 0 0 0 0 0 0 0 0 0 0 0 0 0 0 0 0 0 0 0 0 0 W W 0 0 0 0 W 0 0 0 0 0 0 0 0 0 W 0 0 0 0 0 0 0 0 0 0 0 0 0 0 0 0 A 0 0 0 0 0 0 0 0 0 0 0 0 1 1 2 8 6 5 4 3 1 0 0 0 0 0 0 0 0 0 0 0 0 W W W U U U U U U U U U U U U U U U 
U U U U U U U U U U U 0 W W W W W 0 0 0 0 0 0 0 0 0 0 0 1 2 3 4 5 6 6 0 0 0 0 0 0 0 0 0 0 0 0 0 0 0 0 0 0 0 0 0 0 0 0 0 0 0 0 0 0 0 0 0 0 0 0 0 0 0 0 0 W W 0 0 0 0 0 0 0 0 0 0 0 0 0 0 0 0 0 0 0 0 0 0 0 0 0 0 0 0 0 0 0 0 0 0 0 0 0 0 0 0 W W 0 0 0 0 0 A 0 0 0 0 0 0 0 0 1 2 3 0 0 0 0 0 0 0 0 0 0 0 0 0 0 0 0 0 1 1 1 2 6 7 8 9 6 4 3 2 1 0 0 0 0 0 0 0 0 0 0 0 0 W U U U U U U U U U U U U U U U U 
U U U U U U U U U U U W 0 0 0 0 0 0 0 0 0 0 0 0 0 0 0 W W 2 3 4 5 0 0 0 0 0 0 0 0 0 0 0 0 0 0 0 0 0 0 0 0 0 0 0 0 0 0 0 0 0 0 0 0 0 0 0 0 0 0 0 0 0 0 W 0 0 0 0 0 0 0 0 0 0 0 0 0 0 0 0 0 0 0 0 0 0 0 0 0 0 0 0 0 0 0 0 0 0 0 0 0 0 0 0 0 0 0 0 W 0 0 0 0 0 0 0 0 0 0 0 0 0 U U U 0 0 0 0 0 0 0 0 0 0 0 0 0 0 0 0 0 1 2 3 5 6 7 8 9 6 5 4 3 2 W W 0 0 0 0 0 0 0 0 0 0 U U U U U U U U U U U U U U U U U 
U U U U U U U U U U U 0 0 0 0 0 0 0 0 A 0 0 0 0 0 0 0 0 1 W W W W W W 0 0 0 0 0 0 0 0 0 0 A 0 0 0 0 0 0 0 0 A 0 0 0 0 0 0 A 0 0 0 0 A 0 A A 0 0 0 0 A A A 0 0 0 A 0 0 0 0 0 0 0 0 0 0 A 0 A 0 0 0 0 0 0 0 0 0 A 0 0 0 0 A 0 0 0 0 0 0 0 0 0 0 0 0 0 0 0 0 0 0 0 0 0 0 0 0 0 U U U 0 0 0 0 0 0 0 0 0 0 0 0 0 0 0 0 0 1 2 3 6 7 8 9 W W W W W W 2 2 1 0 0 0 0 0 0 0 2 U U U U U U U U U U U U U U U U U U 
U U U U U U U U U U U 0 0 0 0 0 0 0 0 0 0 0 0 0 0 0 0 0 1 2 3 0 0 0 W 0 0 0 0 0 0 0 0 0 0 0 0 0 0 0 0 0 0 0 0 W W W W 0 0 0 0 0 0 0 0 0 0 0 0 0 0 0 0 0 0 0 0 0 0 0 0 0 0 0 0 0 0 0 0 0 0 0 0 0 0 0 0 0 0 0 0 0 0 0 0 0 0 0 0 0 0 0 0 0 0 0 0 0 0 0 0 0 0 0 0 0 0 0 0 0 0 U U U U W W W W 0 0 0 0 0 0 0 0 0 0 0 0 1 2 3 5 6 7 8 9 W U U 6 5 5 4 3 2 2 2 2 2 2 2 U U U U U U U U U U U U U U U U U U U U 
U U U U U U U U U U U 0 0 0 0 0 0 0 0 0 0 0 0 0 0 0 0 0 1 2 3 0 0 0 W W 0 0 0 0 0 0 0 0 A 0 0 0 0 0 0 0 0 0 0 W 0 0 W W W W 0 0 0 0 0 0 0 0 0 0 0 0 0 0 0 0 0 0 0 0 0 0 0 0 0 0 0 0 0 0 0 0 0 0 0 0 0 0 0 0 0 0 0 0 0 0 0 0 0 0 0 0 0 0 0 0 0 0 0 0 0 0 0 0 0 0 0 0 0 0 0 U W W W W 0 0 W 0 0 0 0 0 0 0 0 0 0 0 0 1 2 3 6 7 8 9 W W U U U U 6 5 5 5 5 5 5 5 U U U U U U U U U U U U U U U U U U U U U U 
U U U U U U U U U U U U 0 0 0 0 0 0 0 0 0 0 0 0 0 0 0 1 2 3 0 0 0 0 0 W 0 0 0 0 0 0 0 0 W 0 0 0 0 0 0 0 0 0 W 0 0 0 0 0 0 W W W 0 0 0 0 0 0 0 0 0 0 0 0 0 0 0 0 0 0 0 0 0 0 0 0 0 0 0 0 0 0 0 0 0 0 0 0 0 0 0 0 0 0 0 0 0 0 0 0 0 0 0 0 0 0 1 0 0 0 0 0 0 0 0 0 0 0 0 0 W W W U U U U 0 0 W 0 0 0 0 0 0 0 0 0 W 1 2 3 6 7 8 9 10 W U U U U U U U U U 7 U U U U U U U U U U U U U U U U U U U U U U U U U 
U U U U U U U U U U U U 0 0 0 0 0 0 0 0 0 0 W 0 0 0 0 1 2 0 0 0 0 0 0 0 0 0 0 0 0 0 0 0 W W 0 0 0 0 0 0 0 W W 0 0 0 0 0 0 0 0 0 0 0 0 0 0 0 0 0 0 0 0 0 0 0 0 0 0 0 0 0 0 0 0 0 0 0 0 0 0 0 0 0 0 0 0 0 0 0 0 0 0 0 0 0 0 0 0 0 0 0 0 0 0 1 2 3 0 0 0 0 0 0 0 0 0 0 0 U U U U U U U U U 0 W W 0 0 0 0 0 0 0 W W 2 3 7 8 9 10 U U U U U U U U U U U U U U U U U U U U U U U U U U U U U U U U U U U U U U 
U U U U U U U U U U U U U 0 0 0 0 0 0 0 0 0 W 0 0 0 1 2 3 0 0 0 0 0 0 0 0 0 0 0 0 0 0 0 0 W W W W W W W W W 0 0 0 0 0 0 0 0 0 A 0 0 0 0 0 0 0 0 0 0 0 0 0 0 0 0 0 0 0 0 0 0 W 0 0 0 0 0 0 0 0 0 0 0 0 0 0 0 0 0 0 0 0 0 0 W 0 0 0 0 0 0 0 1 2 3 4 5 0 0 0 0 0 0 0 U U U U U U U U U U U U U W W W W W W W W W 3 8 9 10 U U U U U U U U U U U U U U U U U U U U U U U U U U U U U U U U U U U U U U U U U 
U U U U U U U U U U U U U U 0 0 0 0 0 0 0 0 W 0 0 1 2 3 0 0 0 0 0 0 0 0 0 A 0 0 0 0 0 0 0 0 W W W W W W W 0 0 0 0 0 0 0 0 0 0 0 0 0 0 0 0 0 0 0 0 0 0 0 0 0 0 0 0 0 0 0 0 0 W 0 0 0 0 0 0 0 0 0 0 0 0 0 0 0 0 0 0 0 0 0 0 W 0 0 0 0 0 0 1 2 3 4 5 6 7 8 9 0 U U U U U U U U U U U U U U U U U W W W W W W W U U U U U U U U U U U U U U U U U U U U U U U U U U U U U U U U U U U U U U U U U U U U U U 
U U U U U U U U U U U U U U U U 0 0 0 0 0 0 W 1 2 3 4 5 0 0 0 0 0 0 0 0 0 0 0 0 0 0 0 0 0 0 0 0 0 0 0 0 0 0 0 0 0 0 0 0 0 0 0 0 0 0 0 0 0 0 0 0 0 0 0 W 0 0 0 0 0 0 0 0 0 W 0 0 0 0 0 0 0 0 0 0 0 0 0 0 0 0 0 0 0 0 0 0 0 0 W 0 0 0 0 1 2 3 4 5 W 7 8 9 10 U U U U U U U U U U U U U U U U U U U U U U U U U U U U U U U U U U U U U U U U U U U U U U U U U U U U U U U U U U U U U U U U U U U U U U U 
U U U U U U U U U U U U U U U U U U U 0 1 2 U 4 5 U U U 0 0 0 0 0 W 0 0 0 0 0 0 0 0 0 0 0 0 0 0 0 0 1 2 0 0 0 0 0 0 0 0 0 0 0 0 0 W 0 0 0 0 0 0 0 0 0 W 0 0 0 0 0 0 0 0 0 1 2 3 4 0 0 0 0 0 0 0 0 0 1 2 3 0 0 0 0 0 0 0 0 0 0 0 0 1 2 3 4 5 6 7 W 9 10 U U U U U U U W U U U U U U U U U U U U U U U U U U U U U U U U U U U U U U U U U U U U U U U U U U U U U U U U U U U U U U U U U U U U U U U U U 
U U U U U U U U U U U U U U U U U U U U U U U U U U U U 0 0 0 0 0 W W 0 0 0 0 0 0 0 0 0 0 0 0 0 2 5 7 U U U U U 0 0 0 0 0 0 0 0 0 W 0 0 0 0 0 1 2 3 4 W 0 0 1 2 3 0 1 2 3 U U 6 7 8 9 10 0 1 0 1 2 3 4 5 6 7 8 9 0 1 2 3 4 U U 2 3 4 5 6 7 8 9 10 W U U U U U U U U U W U U U U U U U U U U U U U U U U U U U U U U U U U U U U U U W U U U U U U U U U U U U U U U U U U U U U U U U U U U U U U U U U U 
U U U U U U U U U U U U U U U U U U U U U U U U U U U U 0 0 0 0 0 0 W 0 A 0 0 0 0 0 0 0 0 0 1 2 4 5 U U U U U U U 0 0 0 0 0 0 0 W 0 0 0 0 0 1 2 3 4 5 W 7 8 U U U U U U U U U U U U U U U U U U U U U U U U U U U U U U U U U U U U U U U U U U W U U U U U U U U U U W U U U U U U U U U U U U U U U U U U U U U U U U U U U U U W U U U U U U U U U U U U U U U U U U U U U U U U U U U U U U U U U U 
U U U U U U U U U U U U U U U U U U U U U U U U U U U U 0 0 0 0 0 0 W W 0 0 0 0 0 0 0 0 0 0 1 2 5 U U U U U U U U U 0 0 0 0 0 W W 0 0 0 0 1 2 3 4 5 6 W 8 U U U U U U U U U U U U U U U U U U U U U U U U U U U U U U U U U U U U U U U U U U U W U U U U U U U U U U W W U U U U U U U U W U U U U U U U U U U U U U U U U U U W U U U U U U U U U U U U U U U U U U U U U U U U U U U U U U U U U U U 
U U U U U U U U U U U U U U U U U U U U U U U U U U U U 0 0 0 0 0 0 W 0 0 0 0 0 0 0 0 0 0 1 2 5 U U U U U U U U U U U U 0 0 W W 0 0 0 1 2 3 4 5 6 7 8 U W U U U U U U U U U W U U U U U U U U U U U U U U U U U U U U U U W U U U U U U U U U W U U U U U U U U U U U U W W U U U U U U U W U U U U U U U U U U U U U U U U U U U U U U U U U U U U U U U U U U U U U U U U U U U U U U U U U U U U U U 
U U U U U U U U U U U U U U U U U U U U U U U U U U U U U 0 0 0 0 0 W F 0 0 0 0 0 0 0 W 1 2 U U U U U U U U U U U U U U U U U U U U 3 4 5 6 7 8 U U U U W U U U U U U U U W W U U U U U U U U U U U U U U U U U U U U U U W W U U U U U U U U W U U U U U U U U U U U U U U U U U U U U U U W U U U U U U U U U W U U U U U U U U U U U U U U U U U U U U U U U U U U U U U U U U U U U U U U U U U U U 
U U U U U U U U U U U U U U U U U U U U U U U U U U U U U 0 0 0 0 W 0 0 0 0 0 0 0 0 0 0 W U U U U U U U U U U U U U U U U U U U U U U U U U U U U U U U W U U U U U U U W W U U U U U U U U U U U U U U U U U U U U U U U U W W U U U U U U U W U U U U U U U U U U U U U U U U U U U U U U U W U U U U U U W W U U U U U U U U U U U U U U U U U U U U U U U U U U U U U U U U U U U U U U U U U U U U 
U U U U U U U U U U U U U U U U U U U U U U U U U U U U U U 0 0 0 W 0 0 0 0 0 0 0 0 0 1 U U U U U U U U U U U U U U U U U U U U U U U U U U U U U U U U W U U U U U U W W U U U U U U U U W W U U U U U U W W U U U U U U U U W W U U U U U U W U U U U U U U U U U U U U U U U U U U U U U U W W W W W W W U U U U U U U U U U U U U U U U U U U U U U U U U U U U U U U U U U U U U U U U U U U U U U 
U U U U U U U U U U U U U U U U U U U U U U U U U U U U U U U 0 0 W 0 0 0 0 0 0 0 0 1 U U U U U U U U U U U U U U U U U U U U U U U U U U U U U U U U U U U U U U U U W U U U U U U U U U W U U U U U U U U W U U U U U U U U U W U U U U U U W U U U U U U U U U U U U U U U U U U U U U U U U W U U U U U U U U U U U U U U U U U U U U U U U U U U U U U U U U U U U U U U U U U U U U U U U U U U U 
U U U U U U U U U U U U U U U U U U U U U U U U U U U U U U U U U 0 0 0 0 0 0 0 1 U U U U U U U U U U U U U U U U U U U U U U U U U U U U U U U U U U U U U U U U U U W W U U U U U U U U U U U U U U U U U U U U U U U U U U W W U U U U U U W W W W W U U U U U U U U U U U U U U U U U U U U U U U U U U U U U U U U U U U U U U U W U U U U U W W U U U U U U U U U U U U U U U U U U U U U U U U U 